Etablissement,Département,Région,Classement Plus-Value (2021),Moyenne du Lycée au BAC (2019),Classement Parcoursup (2019),Classement L'étudiant (2021),Différence
Lycée Pierre de La Ramee,2,Hauts-de-France,1,13.18181818181818,121,36,85
Lycée Chrestien de Troyes,10,Grand Est,2,12.73913043478261,129,62,67
Lycée Pierre-Gilles de Gennes - ENCPB,75,Ile-de-France,3,12.76623376623377,128,71,57
Lycée Pierre d'Ailly,60,Hauts-de-France,4,13.69565217391304,110,55,55
Lycée Marceau,28,Centre-Val de Loire,5,14.0,101,51,50
Lycée Saliège,31,Occitanie,6,14.5959595959596,76,30,46
Lycée Aristide Briand,27,Normandie,7,12.91304347826087,127,81,46
LYCEE POLYVALENT GUSTAVE MONOD,95,Ile-de-France,8,12.37931034482759,134,89,45
Lycée Louis Thuillier,80,Hauts-de-France,9,14.06976744186047,97,56,41
Lycée Honoré De Balzac,75,Ile-de-France,10,12.46153846153846,132,92,40
Lycée Jacques Decour,75,Ile-de-France,11,14.23076923076923,88,49,39
Lycée Jean Baptiste Corot,91,Ile-de-France,12,14.08571428571429,96,57,39
Lycée de L'Emperi,13,Provence Alpes Côte d'Azur,13,12.63636363636364,130,92,38
Pôle Kerichen-Vauban,29,Bretagne,14,14.54929577464789,78,45,33
Lycée ASSOMPTION,35,Bretagne,15,14.16666666666667,92,59,33
Lycée St Joseph,84,Provence Alpes Côte d'Azur,16,12.44,133,101,32
Lycée Alphonse DAUDET,30,Occitanie,17,13.57142857142857,114,82,32
Lycée Berthollet,74,Auvergne-Rhône-Alpes,18,14.49450549450549,79,48,31
Lycée Franklin Roosevelt,51,Grand Est,19,14.09375,94,63,31
Lycée Robespierre,62,Hauts-de-France,20,14.17241379310345,91,60,31
Lycée Carnot,21,Bourgogne-Franche-Comté,22,14.63157894736842,72,42,30
Lycée Carnot,75,Ile-de-France,22,14.63157894736842,72,42,30
Lycée Claude Fauriel,42,Auvergne-Rhône-Alpes,23,14.60714285714286,73,44,29
Lycée Jean Perrin,13,Provence Alpes Côte d'Azur,25,14.6,75,46,29
Lycée Jean Perrin,69,Auvergne-Rhône-Alpes,25,14.6,75,46,29
Lycée Laperouse,81,Occitanie,26,13.86363636363636,102,76,26
Lycée Théophile Gautier,65,Occitanie,27,13.08333333333333,122,96,26
Lycée Descartes,37,Centre-Val de Loire,29,15.06451612903226,53,27,26
Lycée Descartes,78,Ile-de-France,29,15.06451612903226,53,27,26
Lycée François Arago,66,Occitanie,30,13.64516129032258,113,89,24
Lycée Jacques Amyot,89,Bourgogne-Franche-Comté,32,13.41379310344828,118,95,23
Lycée Jacques Amyot,77,Ile-de-France,32,13.41379310344828,118,95,23
Lycée Michelet,92,Ile-de-France,33,15.90909090909091,30,8,22
Lycée Chaptal,75,Ile-de-France,34,15.63829787234043,37,17,20
Lycée Turgot,75,Ile-de-France,35,14.09090909090909,95,76,19
Lycée Auguste Brizeux,29,Bretagne,36,13.24242424242424,119,101,18
Lycée Edmond Perrier,19,Nouvelle-Aquitaine,37,13.83333333333333,104,86,18
Lycée Paul Cezanne,13,Provence Alpes Côte d'Azur,38,15.34042553191489,43,27,16
Lycée Fabert,57,Grand Est,39,15.0,55,40,15
Lycée Assomption Bellevue,69,Auvergne-Rhône-Alpes,40,14.0,100,86,14
Lycée Louis Barthou,64,Nouvelle-Aquitaine,41,13.70769230769231,108,94,14
Lycée Dumont d'Urville,83,Provence Alpes Côte d'Azur,42,13.65573770491803,112,100,12
Lycée Montesquieu,72,Pays de la Loire,43,14.75,64,53,11
Lycée Jeanne D'Albret,78,Ile-de-France,44,14.43478260869565,83,73,10
Lycée Lavoisier,75,Ile-de-France,45,14.34883720930233,85,75,10
Lycée Buffon,75,Ile-de-France,47,14.95121951219512,56,47,9
Lycée Victor Hugo,14,Normandie,48,14.83870967741935,62,53,9
Lycée Victor Hugo,25,Bourgogne-Franche-Comté,48,14.83870967741935,62,53,9
Lycée Bertran De Born,24,Nouvelle-Aquitaine,49,13.69767441860465,109,101,8
Lycée Kléber,67,Grand Est,50,15.92682926829268,28,21,7
Lycée Blaise Pascal,63,Auvergne-Rhône-Alpes,52,16.08333333333333,25,18,7
Lycée Blaise Pascal,91,Ile-de-France,52,16.08333333333333,25,18,7
Lycée Fénelon,75,Ile-de-France,53,16.11111111111111,21,14,7
Lycée Déodat de Séverac,31,Occitanie,54,15.3956043956044,40,33,7
Lycée Marcelin Berthelot,94,Ile-de-France,55,15.87591240875912,31,26,5
Lycée Charlemagne,75,Ile-de-France,56,15.62222222222222,38,33,5
Lycée Pierre Corneille,76,Normandie,57,15.92631578947368,29,24,5
Lycée Fénelon Sainte-Marie,75,Ile-de-France,58,16.18181818181818,18,14,4
Lycée Henri IV,75,Ile-de-France,59,16.75,6,2,4
Lycée général et technologique Aristide Briand,44,Pays de la Loire,60,14.24324324324324,87,83,4
Lycée Champollion,38,Auvergne-Rhône-Alpes,61,16.11428571428571,20,16,4
Lycée Henri Poincaré,54,Grand Est,62,15.85057471264368,34,31,3
Lycée Jean Bart,59,Hauts-de-France,63,14.69230769230769,67,64,3
Lycée Lakanal,92,Ile-de-France,64,16.35353535353535,15,12,3
Lycée Louis Pasteur,92,Ile-de-France,65,16.62222222222222,10,7,3
Lycée Hoche,78,Ile-de-France,66,16.64044943820225,8,6,2
Lycée Lalande,1,Auvergne-Rhône-Alpes,67,13.83333333333333,103,101,2
Lycée Louis Le Grand,75,Ile-de-France,68,16.95402298850575,2,1,1
Lycée Pothier,45,Centre-Val de Loire,69,14.71830985915493,66,66,0
Lycée Stanislas,75,Ile-de-France,70,16.82608695652174,5,5,0
Lycée Sainte Geneviève,78,Ile-de-France,71,16.95161290322581,3,3,0
Pôle Chateaubriand - Joliot-Curie,35,Bretagne,72,16.14285714285714,19,20,-1
Lycée Pierre De Fermat,31,Occitanie,73,16.62790697674419,9,11,-2
Lycée Henri Wallon,59,Hauts-de-France,74,15.71264367816092,35,37,-2
Lycée Montaigne,33,Nouvelle-Aquitaine,75,16.4375,11,13,-2
Lycée Saint-Louis (6ème),75,Ile-de-France,76,16.67932489451477,7,10,-3
Lycée général Clemenceau,44,Pays de la Loire,77,16.43478260869565,12,15,-3
Lycée Masséna,6,Provence Alpes Côte d'Azur,78,16.34939759036144,16,19,-3
Lycée Aux Lazaristes,69,Auvergne-Rhône-Alpes,79,16.95833333333333,1,4,-3
Lycée Sainte Marie,92,Ile-de-France,81,15.31818181818182,45,49,-4
Lycée Sainte Marie,59,Hauts-de-France,81,15.31818181818182,45,49,-4
Lycée du Parc,69,Auvergne-Rhône-Alpes,82,16.92647058823529,4,9,-5
Lycée Thiers,13,Provence Alpes Côte d'Azur,83,16.33333333333333,17,22,-5
Lycée Camille Jullian,33,Nouvelle-Aquitaine,84,15.29787234042553,46,52,-6
Lycée René Cassin Bayonne,64,Nouvelle-Aquitaine,85,14.57894736842105,77,84,-7
Lycée Bellevue,972,Martinique,86,15.06451612903226,51,58,-7
Lycée Condorcet,75,Ile-de-France,87,15.875,32,40,-8
Lycée Janson De Sailly,75,Ile-de-France,88,16.40322580645161,14,23,-9
Lycée Dupuy De Lôme,56,Bretagne,89,14.86363636363636,60,70,-10
Lycée Albert Schweitzer,93,Ile-de-France,91,14.48717948717949,81,91,-10
Lycée Albert Schweitzer,68,Grand Est,91,14.48717948717949,81,91,-10
Lycée Joffre,34,Occitanie,92,16.10769230769231,22,33,-11
Lycée général et technologique Henri Bergson,49,Pays de la Loire,93,14.68181818181818,68,80,-12
Lycée La Martiniere Monplaisir,69,Auvergne-Rhône-Alpes,94,15.96402877697842,26,38,-12
Lycée Francois Ier,77,Ile-de-France,95,14.89189189189189,59,71,-12
Lycée François 1er,76,Normandie,96,14.63636363636364,70,85,-15
Lycée Militaire Prytanee National,72,Pays de la Loire,97,15.23076923076923,48,66,-18
Lycée Faidherbe,59,Hauts-de-France,98,16.41935483870968,13,32,-19
Lycée Jean Dautet,17,Nouvelle-Aquitaine,99,14.82608695652174,63,82,-19
LGT Saint-Stanislas,44,Pays de la Loire,100,14.64444444444444,69,98,-29
Lycée BELLEVUE,31,Occitanie,101,16.08510638297872,23,58,-35
Lycée Leconte de Lisle,974,La Réunion,102,14.72972972972973,65,101,-36
Lycée Gay-Lussac,87,Nouvelle-Aquitaine,103,15.85106382978723,33,69,-36
Lycée Albert Chatelet,59,Hauts-de-France,104,15.23809523809524,47,88,-41
Lycée Camille Guérin,86,Nouvelle-Aquitaine,105,15.0,54,98,-44
